{
   "start":"23,20",
   "end":"42,2",
   "map":[
      "2222222222222222222222222222222222222222222",
      "2222222222222222222222222222222222222222222",
      "2233333333333333333333333333333333333333333",
      "2233333333333333322222222222222222222222222",
      "2233333333333333333333333333333333333333322",
      "2222222222222222222222223333333333333333322",
      "2233333333333333333333333333333333333333322",
      "2233333333333322222222222222222222222222222",
      "2233333333333333333333333333333333333333322",
      "2222222222222222222222222333333333333333322",
      "2233333333333333333333333333333333333333322",
      "2233333333333333333333332222222222222222222",
      "2233333333333333333333333333333333333333322",
      "2233333322222222222222222333333333333333322",
      "2233333333333333333333333333333333333333322",
      "2222222222222223333333333333333333333333322",
      "2233333333333333333333333333333333333333322",
      "2233333333333333333333222222222222222222222",
      "2233333333333333333333333333333333333333322",
      "2222222222222222222222232222222222222222222",
      "2222222222222222222222232222222222222222222"
   ],
   "wave":[
      "7 5=5 6=10 interval=1",
      "14 4=10 1=15 interval=1",
      "21 2=20 3=25 interval=1"
   ],
   "LevelNumber":"2 - 3"
}