{
   "start":"0,9",
   "end":"38,12",
   "map":[
      "000000000000000000000000000000000000000",
      "000000000000000000000000000000000000000",
      "000000000000000000000000000000000000000",
      "000000000000000000000000000000000000000",
      "001111111111100111110000001111111100000",
      "001111111111111111110001111111100011100",
      "001111111111111111100011111100111111100",
      "001111001111111111000011111111111111100",
      "001111001111111111100011111111111111100",
      "111111011001111111110011111100111111100",
      "001111111001111111111011111100111111100",
      "001111001111100111111011111100111111100",
      "001100111110011111111111111100111111111",
      "001111001111100111111111111100111111100",
      "000000000000000000000000000000000000000",
      "000000000000000000000000000000000000000",
      "000000000000000000000000000000000000000",
      "000000000000000000000000000000000000000"
   ],
   "wave":[
      
   ],
   "LevelNumber":"1 - 3"
}