{
   "start":"42,10",
   "end":"19,0",
   "map":[
      "2222222222222222222322222222222222222222222",
      "2222222222222222222322222222222222222222222",
      "2233333333333333333323333333333332333333322",
      "2233333333333333332233333333233323333333322",
      "2233333333333333323333333332333233333333322",
      "2233333333333333233333333323332333333333322",
      "2233333333333332333333333223332333333333322",
      "2233333333333323333333222233332222223333322",
      "2233333333333233322222333333323333333333322",
      "2233333322222333233333333332233333333333322",
      "2233333233333332333333333323333333333333333",
      "2233332333333323333333333233333333322222222",
      "2233332333322233333333333233333333333333322",
      "2233323333233333333333332333333333333333322",
      "2233333332333333333333332333222222222233322",
      "2233333323333333333333332333333333333333322",
      "2233333233333333333333333333333333333333322",
      "2233332333333333333333333333333333333333322",
      "2233323333333333333333333333333333333333322",
      "2222222222222222222222222222222222222222222",
      "2222222222222222222222222222222222222222222"
   ],
   "wave":[
      "5 1=2 5=3 interval=1",
      "10 2=8 6=9 interval=1",
      "15 3=16 6=18 interval=1",
      "20 4=24 1=27 interval=1"
   ],
   "LevelNumber":"2 - 5"
}