{
   "start":"18,0",
   "end":"21,17",
   "map":[
      "000000000000000000100000000000",
      "000000000000000000100000000000",
      "001111111111111111111111111100",
      "001111111111111111111111111100",
      "001111000000000000001111111100",
      "001111111100000001111111111100",
      "001111111111110000000000111100",
      "001111111111111111101111111100",
      "001111111111111111101111111100",
      "001111000001111111101101111100",
      "001111011111111111101101111100",
      "001111011110111011101100111100",
      "001111011111111111101100111100",
      "001111001111011101111111111100",
      "001111111111111111111111111100",
      "001111111111111111111111111100",
      "000000000000000000000100000000",
      "000000000000000000000100000000"
   ],
   "wave":[
      
   ],
   "LevelNumber":"1 - 4"
}