{
   "start":"2,20",
   "end":"30,0",
   "map":[
      "0000000000000000000000000000001000",
      "0000000000000000000000000000001000",
      "0011111111111111111111111000011100",
      "0011111111111111111111111111111100",
      "0011110000000000000011111111111100",
      "0011111111000000011111111111111100",
      "0011111111111100000000001111111100",
      "0011111111111111111011111111011100",
      "0011111111111111111111101111111100",
      "0011110000011111111011111101111100",
      "0011110111111111111011011111111100",
      "0011110111101110111011001111111100",
      "0011110111111111111111101100111100",
      "0011110011111111011101111111111100",
      "0011110111111111000000111111111100",
      "0011110111111111110011111111111100",
      "0011110011111111110111111111111100",
      "0011111111111111111111111111111100",
      "0011111111111111111111111111111100",
      "0010000000000000000000000000000000",
      "0010000000000000000000000000000000"
   ],
   "wave":[
      
   ],
   "LevelNumber":"1 - 5"
}