{
   "start":"0,16",
   "end":"42,10",
   "map":[
      "4444444444444444444444444444444444444444444",
      "4444444444444444444444444444444444444444444",
      "4455555555555555555555555555555555555555544",
      "4455555555555555555555555555555555555555544",
      "4455555555555555555555555555555555555555544",
      "4455555555555555555555555555555555555555544",
      "4455555555555555555555555555555555555555544",
      "4455555555555555555555555555555555555555544",
      "4455555555555555555555555555555555555555544",
      "4455555555555555555555555555554444444444444",
      "4455555444444444445555555555545555555555555",
      "4455555455555555545555555555455544444444444",
      "4455555455444445544444444454555455555555544",
      "4455555455455545555555555445554555555555544",
      "4455555455455544444444555455554555555555544",
      "4444444455455555555554555455554555555555544",
      "5555555555455555555554555455554555555555544",
      "4444444444455555555554555555554555555555544",
      "4455555555555555555554444444444555555555544",
      "4444444444444444444444444444444444444444444",
      "4444444444444444444444444444444444444444444"
   ],
   "wave":[
      "10 1=5 3=5 interval=1",
      "20 2=15 2=10 interval=1",
      "25 5=10 6=20 interval=1"
   ],
   "LevelNumber":"2 - 6"
}