{
   "start":"0,10",
   "end":"42,10",
   "map":[
      "0000000000000000000000000000000000000000000",
      "0000000000000000000000000000000000000000000",
      "0011111111111111111111111111111111111111100",
      "0011111111111111111111111111111111111111100",
      "0011111111111111111111111111111111111111100",
      "0011111111111111111111111111111111111111100",
      "0011111111111111111111111111111111111111100",
      "0011111111111111111111111111111111111111100",
      "0011111111111111111111111111111111111111100",
      "0011111111111111111111111111111111111111100",
      "1111111111111111111111111111111111111111111",
      "0011111111111111111111111111111111111111100",
      "0011111111111111111111111111111111111111100",
      "0011111111111111111111111111111111111111100",
      "0011111111111111111111111111111111111111100",
      "0011111111111111111111111111111111111111100",
      "0011111111111111111111111111111111111111100",
      "0011111111111111111111111111111111111111100",
      "0011111111111111111111111111111111111111100",
      "0000000000000000000000000000000000000000000",
      "0000000000000000000000000000000000000000000"
   ],
   "wave":[
      "15 0=1 1=1 interval=2",
      "20 0=20 1=25 interval=1"
   ],
   "LevelNumber":"1 - 1"
}