{
   "start":"0,10",
   "end":"42,10",
   "map":[
      "4444444444444444444444444444444444444444444",
      "4444444444444444444444444444444444444444444",
      "4455555555555455555555555555555555555555544",
      "4455555555555455555555555555555555555555544",
      "4455555555555455544444444444444444444455544",
      "4455444445555455545555555555555555555555544",
      "4455555545555455545555555555555555555555544",
      "4455555545555455545554444444444444444444444",
      "4455555545555455545555555555555555555555544",
      "4444455545555455545554555555555555544444444",
      "5555455545555455545554555555555555545555555",
      "4455455545555455545554444444444444445554444",
      "4455455545555455545555555555555555555555544",
      "4455555545555555545555555555555555555555544",
      "4444444445555455544444444444444444444444444",
      "4455555555555455555555555555555555555555544",
      "4455555555555455555555555555555555555555544",
      "4455555555555444444444444444444444444455544",
      "4455555555555555555555555555555555555555544",
      "4444444444444444444444444444444444444444444",
      "4444444444444444444444444444444444444444444"
   ],
   "wave":[
      "10 7=15 6=10 interval=1",
      "20 7=20 5=25 interval=1"
   ],
   "LevelNumber":"2 - 7"
}