{
   "start":"0,10",
   "end":"42,10",
   "map":[
      "2222222222222222222222222222222222222222222",
      "2222222222222222222222222222222222222222222",
      "2233333333222222222222222222222222222222222",
      "2233333332333333333333333333323333333333322",
      "2233333332322222222222222222323333333333322",
      "2233333332323333333333333332323333333333322",
      "2233333332323333333333333332323333333333322",
      "2233333332322222222222222222323333333333322",
      "2233333332323333333333333332323333333333322",
      "2222222222323233333333333333323222222222222",
      "3333333333323222222222222222232333333333333",
      "2222222222223233333333333333333232222222222",
      "2233333333333233333333333333333232333333322",
      "2233333333333233333333333333333232333333322",
      "2233333333333233333333333333333232333333322",
      "2233333333333233333333333333333232333333322",
      "2233333333333232222222222222222232333333322",
      "2233333333333333333333333333333332333333322",
      "2222222222222222222222222222222223333333322",
      "2222222222222222222222222222222222222222222",
      "2222222222222222222222222222222222222222222"
   ],
   "wave":[
      "3 1=9 4=6 interval=1",
      "6 2=19 5=16 interval=1",
      "9 3=20 6=25 interval=1"
   ],
   "LevelNumber":"2 - 2"
}