{
   "start":"20,0",
   "end":"0,18",
   "map":[
      "2222222222222222222232222222222222222222222",
      "2222222222222222222232222222222222222222222",
      "2233333333333333333333333333333333333333322",
      "2233333333333333332222233333333333333333322",
      "2233333333332222223333322222233333333333322",
      "2233333333333333333323333333333333333333322",
      "2222222222222233222232222332222222222222222",
      "2233333333333333333333333333333333333333322",
      "2233333322222222233333332222222223333333322",
      "2233333333333333333333333333333333333333322",
      "2222222222333333333333333333333222222222222",
      "2233333332333333333333333333333333333333322",
      "2233333333222222222222223333333333333333322",
      "2233333333333333333333333333333333333333322",
      "2233333333333322222222222222222222222222222",
      "2233333333333333333333333333333333333333322",
      "2222222222222222222222222222222233333333322",
      "2233333333333333333333333333333333333333322",
      "3333333333333333333333333333333333333333322",
      "2222222222222222222222222222222222222222222",
      "2222222222222222222222222222222222222222222"
   ],
   "wave":[
      "5 7=10 6=5 interval=1",
      "15 5=25 4=25 interval=1"
   ],
   "LevelNumber":"2 - 1"
}