{
   "start":"42,10",
   "end":"0,10",
   "map":[
      "0000000000000000000000000000000000000000000",
      "0000000000000000000000000000000000000000000",
      "0011111111111001111100000011111111111100000",
      "0011111111111111111100000011111111100011100",
      "0011111111111111111110000011111100111111100",
      "0011110011111111111111000011111111111111100",
      "0011110011111001111111100011111111111111100",
      "0011110011111001111111110011111100111111100",
      "0000000011111001111111111011111100111111100",
      "0011110011111001111111111011111100111111100",
      "1111110011111001111111111111111100111111111",
      "0011110011111001111111111111111100111111100",
      "0011110011111001111111111111111100111111100",
      "0011110011111001111111111011111100111111100",
      "0011110011111001111111110011111100111111100",
      "0011110011111111111111100011111100000000000",
      "0011111111111111111111000011111111111111100",
      "0011111111111111111110000011111111111111100",
      "0011111111111111111110000011111111111111100",
      "0000000000000000000000000000000000000000000",
      "0000000000000000000000000000000000000000000"
   ],
   "wave":[
      
   ],
   "LevelNumber":"1 - 2"
}