{
   "start":"42,18",
   "end":"42,10",
   "map":[
      "2222222222222222222222222222222222222222222",
      "2222222222222222222222222222222222222222222",
      "2233333333333333333333333333333333333333322",
      "2233322222222222222222222222222222222333322",
      "2233323333333333333333333333333333332333222",
      "2233323333333333333333333333333333323332322",
      "2233323333333333333333333333333333233323322",
      "2233323333333333333333333333333332333233322",
      "2233323333333333333333333333333323332333322",
      "2233323333333333333333333333333233323333322",
      "2233323333333333333333333333332333233333333",
      "2233323333333333333333333333332333233333322",
      "2233323333333333333333333333332333333333322",
      "2233323333333333333333333333332333333333322",
      "2233323333333333333333333333332222222222222",
      "2233323333333333333333333333333333333333322",
      "2233323333333333333333333333333333333333322",
      "2233322222222222222222222222222222222222222",
      "2233333333333333333333333333333333333333333",
      "2222222222222222222222222222222222222222222",
      "2222222222222222222222222222222222222222222"
   ],
   "wave":[
      "15 3=1 5=1 interval=1",
      "20 2=20 3=25 4=10 6=30 interval=1",
      "25 4=10 6=30 interval=1"
   ],
   "LevelNumber":"2 - 4"
}