{
	"start":"0,10",

	"end":"42,10",
		
	"map":[
"4444444444444444444444444444444444444444444",
"4444444444444444444444444444444444444444444",
"4455555554555555555555545555555555455555544",
"4455555554555555555555545555555555455555544",
"4455555554555555455555545555555555455555544",
"4455555554555555455555545555555555455555544",
"4455555554555555455555545555555555455555544",
"4455555555555555455555545555545555455555544",
"4455555554444444455555545555545555455545544",
"4455555554555555555555545555545555455545544",
"5555555554555544444455555555545555555545555",
"4455555554555555555555545555545555455545544",
"4455555554444444455555545555545555455545544",
"4455555555555555455555545555545555455555544",
"4455555554555555455555545555555555455555544",
"4455555554555555455555545555555555455555544",
"4455555554555555455555545555555555455555544",
"4455555554555555555555545555555555455555544",
"4455555554555555555555545555555555455555544",
"4444444444444444444444444444444444444444444",
"4444444444444444444444444444444444444444444"],

	"wave":[
	"5 5=5 2=5 interval=1",
	"10 6=10 3=10 interval=1",
	"15 4=15 5=15 interval=1",
	],

	"LevelNumber":"2 - 8"
}