{
   "start":"0,3",
   "end":"0,17",
   "map":[
      "2222222222222222222222222222222222222222222",
      "2222222222222222222222222222222222222222222",
      "2233333333333333233333333333333333333333322",
      "3333333333333333222222222222222322222222222",
      "2233333333333333233333333332333333332333322",
      "2222222222333333233333333332333333332333322",
      "2233233333333333233333233332333233332333322",
      "2233233333333333233333233332333233332333322",
      "2233233332222222233333233332333233332333322",
      "2233233333333333333333233332333233332222222",
      "2233233333333333333333233332333233333333322",
      "2233222222222222222222233332333233333333322",
      "2232333333333333333333233333333222222233322",
      "2232333333333333333333233333333233333233322",
      "2232333322222333333333222222222233333233322",
      "2232333333333222223333333333333332333233322",
      "2232222223333333333222333333333332333233322",
      "3333333332222233333333332333333332333333322",
      "2222223333333333333333333233333332333333322",
      "2222222222222222222222222222222222222222222",
      "2222222222222222222222222222222222222222222"
   ],
   "wave":[
      "5 3=4 1=1 interval=1",
      "10 2=8 4=5 interval=1",
      "15 5=16 1=10 interval=1"
   ],
   "LevelNumber":"1 - 6"
}