{
   "start":"20,20",
   "end":"42,2",
   "map":[
      "2222222222222222222222222222222222222222222",
      "2222222222222222222222222222222222222222222",
      "2233333323333333333333333323333333333333333",
      "2233333332333333333333333332333333333333322",
      "2233333333233333333333333333233333333333322",
      "2233333333322333333333333333323333333333322",
      "2233333333333233333333233333332333333333322",
      "2233333333333323333333323333333333333333322",
      "2222333333333332333333332333333323333333322",
      "2233222233333333233333333233333332333333322",
      "2233333333333333322222233323333333222222222",
      "2233332333332233333333333332333333333333322",
      "2233333233223323333333333333233333333333322",
      "2233333322333332333333333333323333333333322",
      "2233333333333333223333333333332333333333322",
      "2233333333333333333233333333333233333333322",
      "2233333333333333333323333333333333333333322",
      "2233333333333333333332333333333333333333322",
      "2233333333333333333332333333333333333333322",
      "2222222222222222222232222222222222222222222",
      "2222222222222222222232222222222222222222222"
   ],
   "wave":[
      "10 2=3 3=3 interval=1",
      "20 2=20 3=20 interval=1"
   ],
   "LevelNumber":"1 - 7"
}